...###....#
..##.#.#.##
.##..###..#
##.....@..#
#......#..#
###..###..#
..#..#....#
.##.##.#.##
.#......##.
.#.....##..
.##........
