...#.###.#.
#...#.##.#.
#..#..#..#.
...##..#...
####################################
#.......#......#..........#.........#....
#@..................#........#...........
#...#...........#........................
#......#...............#.......#......#..
#..##......#...#....#.......#......#.....
####################################
